0,2,5,5,5,5,5,5,5,5,5,5,5,5,5,5,5,5,5,5,5,5,5,5,5,5,5,5,5,5,5,5
4,0,2,5,5,5,5,5,5,1,5,5,5,5,5,5,5,5,5,5,5,5,5,5,5,5,5,5,5,5,5,5
5,4,0,2,5,5,5,5,5,5,1,5,5,5,5,5,5,5,5,5,5,5,5,5,5,5,5,5,5,5,5,5
5,5,4,0,2,5,5,5,5,5,5,1,5,5,5,5,5,5,5,5,5,5,5,5,5,5,5,5,5,5,5,5
5,5,5,4,0,2,5,5,5,5,5,5,1,5,5,5,5,5,5,5,5,5,5,5,5,5,5,5,5,5,5,5
5,5,5,5,4,0,2,5,5,5,5,5,5,1,5,5,5,5,5,5,5,5,5,5,5,5,5,5,5,5,5,5
5,5,5,5,5,4,0,2,5,5,5,5,5,5,1,5,5,5,5,5,5,5,5,5,5,5,5,5,5,5,5,5
5,5,5,5,5,5,4,0,5,5,5,5,5,5,5,5,5,5,5,5,5,5,5,5,5,5,5,5,5,5,5,5
5,5,5,5,5,5,5,5,0,2,5,5,5,5,5,5,5,5,5,5,5,5,5,5,5,5,5,5,5,5,5,5
5,3,5,5,5,5,5,5,4,0,2,5,5,5,5,5,5,1,5,5,5,5,5,5,5,5,5,5,5,5,5,5
5,5,3,5,5,5,5,5,5,4,0,2,5,5,5,5,5,5,1,5,5,5,5,5,5,5,5,5,5,5,5,5
5,5,5,3,5,5,5,5,5,5,4,0,2,5,5,5,5,5,5,1,5,5,5,5,5,5,5,5,5,5,5,5
5,5,5,5,3,5,5,5,5,5,5,4,0,2,5,5,5,5,5,5,1,5,5,5,5,5,5,5,5,5,5,5
5,5,5,5,5,3,5,5,5,5,5,5,4,0,2,5,5,5,5,5,5,1,5,5,5,5,5,5,5,5,5,5
5,5,5,5,5,5,3,5,5,5,5,5,5,4,0,2,5,5,5,5,5,5,1,5,5,5,5,5,5,5,5,5
5,5,5,5,5,5,5,5,5,5,5,5,5,5,4,0,5,5,5,5,5,5,5,5,5,5,5,5,5,5,5,5
5,5,5,5,5,5,5,5,5,5,5,5,5,5,5,5,0,2,5,5,5,5,5,5,5,5,5,5,5,5,5,5
5,5,5,5,5,5,5,5,5,3,5,5,5,5,5,5,4,0,5,5,5,5,5,5,5,1,5,5,5,5,5,5
5,5,5,5,5,5,5,5,5,5,3,5,5,5,5,5,5,5,0,2,5,5,5,5,5,5,1,5,5,5,5,5
5,5,5,5,5,5,5,5,5,5,5,3,5,5,5,5,5,5,4,0,5,5,5,5,5,5,5,1,5,5,5,5
5,5,5,5,5,5,5,5,5,5,5,5,3,5,5,5,5,5,5,5,0,2,5,5,5,5,5,5,1,5,5,5
5,5,5,5,5,5,5,5,5,5,5,5,5,3,5,5,5,5,5,5,4,0,5,5,5,5,5,5,5,1,5,5
5,5,5,5,5,5,5,5,5,5,5,5,5,5,3,5,5,5,5,5,5,5,0,2,5,5,5,5,5,5,1,5
5,5,5,5,5,5,5,5,5,5,5,5,5,5,5,5,5,5,5,5,5,5,4,0,5,5,5,5,5,5,5,5
5,5,5,5,5,5,5,5,5,5,5,5,5,5,5,5,5,5,5,5,5,5,5,5,0,2,5,5,5,5,5,5
5,5,5,5,5,5,5,5,5,5,5,5,5,5,5,5,5,3,5,5,5,5,5,5,4,0,5,5,5,5,5,5
5,5,5,5,5,5,5,5,5,5,5,5,5,5,5,5,5,5,3,5,5,5,5,5,5,5,0,2,5,5,5,5
5,5,5,5,5,5,5,5,5,5,5,5,5,5,5,5,5,5,5,3,5,5,5,5,5,5,4,0,5,5,5,5
5,5,5,5,5,5,5,5,5,5,5,5,5,5,5,5,5,5,5,5,3,5,5,5,5,5,5,5,0,2,5,5
5,5,5,5,5,5,5,5,5,5,5,5,5,5,5,5,5,5,5,5,5,3,5,5,5,5,5,5,4,0,5,5
5,5,5,5,5,5,5,5,5,5,5,5,5,5,5,5,5,5,5,5,5,5,3,5,5,5,5,5,5,5,0,2
5,5,5,5,5,5,5,5,5,5,5,5,5,5,5,5,5,5,5,5,5,5,5,5,5,5,5,5,5,5,4,0